1111111111111111111111111111111111
1E0000000000000C00000C000000000001
10100101001000001010010000X0010101
1010010010101010001001000000000101
1P0000000C00C00E000000000000000001
1111111111111111111111111111111111
